66 330 1 0 0 0 0 0
0 400 0 0 0 0 0 0
66 400 1 0 0 0 0 0
132 400 2 0 0 0 0 0
198 400 3 0 0 0 0 0
264 400 4 0 0 0 0 0
330 400 5 0 0 0 0 0
396 400 6 0 0 0 0 0
462 400 7 0 0 0 0 0
528 400 0 0 0 0 0 0
594 400 1 0 0 0 0 0
660 400 2 0 0 0 0 0
726 400 3 0 0 0 0 0
792 400 4 0 0 0 0 0
858 400 5 0 0 0 0 0
924 400 6 0 0 0 0 0
990 400 7 0 0 0 0 0
1056 400 0 0 0 0 0 0
1122 400 1 0 0 0 0 0
1188 400 2 0 0 0 0 0
1254 400 3 0 0 0 0 0
1320 400 4 0 0 0 0 0
1386 400 5 0 0 0 0 0
1452 400 6 0 0 0 0 0
1518 400 7 0 0 0 0 0
1584 400 0 0 0 0 0 0
1650 400 1 0 0 0 0 0
1716 400 2 0 0 0 0 0
1782 400 3 0 0 0 0 0
1848 400 4 0 0 0 0 0
1914 400 5 0 0 0 0 0
1980 400 6 0 0 0 0 0
2046 400 7 0 0 0 0 0
2112 400 0 0 0 0 0 0
2178 400 1 0 0 0 0 0
2244 400 2 0 0 0 0 0
2310 400 3 0 0 0 0 0
2376 400 4 0 0 0 0 0
2442 400 5 0 0 0 0 0
2508 400 6 0 0 0 0 0
2574 400 7 0 0 0 0 0
2640 400 0 0 0 0 0 0
2706 400 1 0 0 0 0 0
2772 400 2 0 0 0 0 0
2838 400 3 0 0 0 0 0
2904 400 4 0 0 0 0 0
2970 400 5 0 0 0 0 0
3036 400 6 0 0 0 0 0
3102 400 7 0 0 0 0 0
3168 400 0 0 0 0 0 0
3234 400 1 0 0 0 0 0
3300 400 2 0 0 0 0 0
3366 400 3 0 0 0 0 0
3432 400 4 0 0 0 0 0
3498 400 5 0 0 0 0 0
3564 400 6 0 0 0 0 0
3630 400 7 0 0 0 0 0
3696 400 0 0 0 0 0 0
3762 400 1 0 0 0 0 0
3828 400 2 0 0 0 0 0
3894 400 3 0 0 0 0 0
3960 400 4 0 0 0 0 0
4026 400 5 0 0 0 0 0
4092 400 6 0 0 0 0 0
4158 400 7 0 0 0 0 0
4224 400 0 0 0 0 0 0
4290 400 1 0 0 0 0 0
4356 400 2 0 0 0 0 0
4422 400 3 0 0 0 0 0
4488 400 4 0 0 0 0 0
4554 400 5 0 0 0 0 0
4620 400 6 0 0 0 0 0
4686 400 7 0 0 0 0 0
4752 400 0 0 0 0 0 0
4818 400 1 0 0 0 0 0
4884 400 2 0 0 0 0 0
4950 400 3 0 0 0 0 0
5016 400 4 0 0 0 0 0
5082 400 5 0 0 0 0 0
5148 400 6 0 0 0 0 0
5214 400 7 0 0 0 0 0
5280 400 0 0 0 0 0 0
5346 400 1 0 0 0 0 0
5412 400 2 0 0 0 0 0
5478 400 3 0 0 0 0 0
5544 400 4 0 0 0 0 0
5610 400 5 0 0 0 0 0
5676 400 6 0 0 0 0 0
5742 400 7 0 0 0 0 0
5808 400 0 0 0 0 0 0
5874 400 1 0 0 0 0 0
5940 400 2 0 0 0 0 0
6006 400 3 0 0 0 0 0
6072 400 4 0 0 0 0 0
6138 400 5 0 0 0 0 0
6204 400 6 0 0 0 0 0
6270 400 7 0 0 0 0 0
6336 400 0 0 0 0 0 0
6402 400 1 0 0 0 0 0
6468 400 2 0 0 0 0 0
6534 400 3 0 0 0 0 0
6600 400 4 0 0 0 0 0
6666 400 5 0 0 0 0 0
6732 400 6 0 0 0 0 0
6798 400 7 0 0 0 0 0
6864 400 0 0 0 0 0 0
6930 400 1 0 0 0 0 0
6996 400 2 0 0 0 0 0
7062 400 3 0 0 0 0 0
7128 400 4 0 0 0 0 0
7194 400 5 0 0 0 0 0
7260 400 6 0 0 0 0 0
7326 400 7 0 0 0 0 0
7392 400 0 0 0 0 0 0
7458 400 1 0 0 0 0 0
7524 400 2 0 0 0 0 0
7590 400 3 0 0 0 0 0
7656 400 4 0 0 0 0 0
7722 400 5 0 0 0 0 0
7788 400 6 0 0 0 0 0
7854 400 7 0 0 0 0 0
7920 400 0 0 0 0 0 0
7986 400 1 0 0 0 0 0
8052 400 2 0 0 0 0 0
8118 400 3 0 0 0 0 0
8184 400 4 0 0 0 0 0
8250 400 5 0 0 0 0 0
8316 400 6 0 0 0 0 0
8382 400 7 0 0 0 0 0
8448 400 0 0 0 0 0 0
8514 400 1 0 0 0 0 0
8580 400 2 0 0 0 0 0
8646 400 3 0 0 0 0 0
8712 400 4 0 0 0 0 0
8778 400 5 0 0 0 0 0
8844 400 6 0 0 0 0 0
8910 400 7 0 0 0 0 0
8976 400 0 0 0 0 0 0
9042 400 1 0 0 0 0 0
9108 400 2 0 0 0 0 0
9174 400 3 0 0 0 0 0
9240 400 4 0 0 0 0 0
9306 400 5 0 0 0 0 0
9372 400 6 0 0 0 0 0
9438 400 7 0 0 0 0 0
9504 400 0 0 0 0 0 0
9570 400 1 0 0 0 0 0
9636 400 2 0 0 0 0 0
9702 400 3 0 0 0 0 0
9768 400 4 0 0 0 0 0
9834 400 5 0 0 0 0 0
9900 400 6 0 0 0 0 0
9966 400 7 0 0 0 0 0
10032 400 0 0 0 0 0 0
10098 400 1 0 0 0 0 0
10164 400 2 0 0 0 0 0
10230 400 3 0 0 0 0 0
10296 400 4 0 0 0 0 0
10362 400 5 0 0 0 0 0
10428 400 6 0 0 0 0 0
10494 400 7 0 0 0 0 0
10560 400 0 0 0 0 0 0
10626 400 1 0 0 0 0 0
10692 400 2 0 0 0 0 0
10758 400 3 0 0 0 0 0
10824 400 4 0 0 0 0 0
10890 400 5 0 0 0 0 0
10956 400 6 0 0 0 0 0
11022 400 7 0 0 0 0 0
11088 400 0 0 0 0 0 0
11154 400 1 0 0 0 0 0
11220 400 2 0 0 0 0 0
11286 400 3 0 0 0 0 0
11352 400 4 0 0 0 0 0
11418 400 5 0 0 0 0 0
11484 400 6 0 0 0 0 0
11550 400 7 0 0 0 0 0
11616 400 0 0 0 0 0 0
11682 400 1 0 0 0 0 0
11748 400 2 0 0 0 0 0
11814 400 3 0 0 0 0 0
11880 400 4 0 0 0 0 0
11946 400 5 0 0 0 0 0
12012 400 6 0 0 0 0 0
12078 400 7 0 0 0 0 0
12144 400 0 0 0 0 0 0
12210 400 1 0 0 0 0 0
12276 400 2 0 0 0 0 0
12342 400 3 0 0 0 0 0
12408 400 4 0 0 0 0 0
12474 400 5 0 0 0 0 0
12540 400 6 0 0 0 0 0
12606 400 7 0 0 0 0 0
12672 400 0 0 0 0 0 0
12738 400 1 0 0 0 0 0
12804 400 2 0 0 0 0 0
12870 400 3 0 0 0 0 0
12936 400 4 0 0 0 0 0
13002 400 5 0 0 0 0 0
13068 400 6 0 0 0 0 0
13134 400 7 0 0 0 0 0
