66 330 1 0 0 0 0 1
0 400 0 0 1 0 0 1
66 400 1 1 1 0 0 1
132 400 2 1 1 0 0 1
198 400 3 1 1 0 0 1
264 400 4 1 1 0 0 1
330 400 5 1 1 0 0 1
396 400 6 1 1 0 0 1
462 400 7 1 1 0 0 1
528 400 0 1 1 0 0 1
594 400 1 1 1 0 0 1
660 400 2 1 1 0 0 1
726 400 3 1 1 0 0 1
792 400 4 1 1 0 0 1
858 400 5 1 1 0 0 1
924 400 6 1 1 0 0 1
990 400 7 1 1 0 0 1
1056 400 0 1 1 0 0 1
1122 400 1 1 1 0 0 1
1188 400 2 1 1 0 0 1
1254 400 3 1 1 0 0 1
1320 400 4 1 1 0 0 1
1386 400 5 1 1 0 0 1
1452 400 6 1 1 0 0 1
1518 400 7 1 1 0 0 1
1584 400 0 1 1 0 0 1
1650 400 1 1 1 0 0 1
1716 400 2 1 1 0 0 1
1782 400 3 1 1 0 0 1
1848 400 4 1 1 0 0 1
1914 400 5 1 1 0 0 1
1980 400 6 1 1 0 0 1
2046 400 7 1 1 0 0 1
2112 400 0 1 1 0 0 1
2178 400 1 1 1 0 0 1
2244 400 2 1 1 0 0 1
2310 400 3 1 1 0 0 1
2376 400 4 1 1 0 0 1
2442 400 5 1 1 0 0 1
2508 400 6 1 1 0 0 1
2574 400 7 1 1 0 0 1
2640 400 0 1 1 0 0 1
2706 400 1 1 1 0 0 1
2772 400 2 1 1 0 0 1
2838 400 3 1 1 0 0 1
2904 400 4 1 1 0 0 1
2970 400 5 1 1 0 0 1
3036 400 6 1 1 0 0 1
3102 400 7 1 1 0 0 1
3168 400 0 1 1 0 0 1
3234 400 1 1 1 0 0 1
3300 400 2 1 1 0 0 1
3366 400 3 1 1 0 0 1
3432 400 4 1 1 0 0 1
3498 400 5 1 1 0 0 1
3564 400 6 1 1 0 0 1
3630 400 7 1 1 0 0 1
3696 400 0 1 1 0 0 1
3762 400 1 1 1 0 0 1
3828 400 2 1 1 0 0 1
3894 400 3 1 1 0 0 1
3960 400 4 1 1 0 0 1
4026 400 5 1 1 0 0 1
4092 400 6 1 1 0 0 1
4158 400 7 1 1 0 0 1
4224 400 0 1 1 0 0 1
4290 400 1 1 1 0 0 1
4356 400 2 1 1 0 0 1
4422 400 3 1 1 0 0 1
4488 400 4 1 1 0 0 1
4554 400 5 1 1 0 0 1
4620 400 6 1 1 0 0 1
4686 400 7 1 1 0 0 1
4752 400 0 1 1 0 0 1
4818 400 1 1 1 0 0 1
4884 400 2 1 1 0 0 1
4950 400 3 1 1 0 0 1
5016 400 4 1 1 0 0 1
5082 400 5 1 1 0 0 1
5148 400 6 1 1 0 0 1
5214 400 7 1 1 0 0 1
5280 400 0 1 1 0 0 1
5346 400 1 1 1 0 0 1
5412 400 2 1 1 0 0 1
5478 400 3 1 1 0 0 1
5544 400 4 1 1 0 0 1
5610 400 5 1 1 0 0 1
5676 400 6 1 1 0 0 1
5742 400 7 1 1 0 0 1
5808 400 0 1 1 0 0 1
5874 400 1 1 1 0 0 1
5940 400 2 1 1 0 0 1
6006 400 3 1 1 0 0 1
6072 400 4 1 1 0 0 1
6138 400 5 1 1 0 0 1
6204 400 6 1 1 0 0 1
6270 400 7 1 1 0 0 1
6336 400 0 1 1 0 0 1
6402 400 1 1 1 0 0 1
6468 400 2 1 1 0 0 1
6534 400 3 1 1 0 0 1
6600 400 4 1 1 0 0 1
6666 400 5 1 1 0 0 1
6732 400 6 1 1 0 0 1
6798 400 7 1 1 0 0 1
6864 400 0 1 1 0 0 1
6930 400 1 1 1 0 0 1
6996 400 2 1 1 0 0 1
7062 400 3 1 1 0 0 1
7128 400 4 1 1 0 0 1
7194 400 5 1 1 0 0 1
7260 400 6 1 1 0 0 1
7326 400 7 1 1 0 0 1
7392 400 0 1 1 0 0 1
7458 400 1 1 1 0 0 1
7524 400 2 1 1 0 0 1
7590 400 3 1 1 0 0 1
7656 400 4 1 1 0 0 1
7722 400 5 1 1 0 0 1
7788 400 6 1 1 0 0 1
7854 400 7 1 1 0 0 1
7920 400 0 1 1 0 0 1
7986 400 1 1 1 0 0 1
8052 400 2 1 1 0 0 1
8118 400 3 1 1 0 0 1
8184 400 4 1 1 0 0 1
8250 400 5 1 1 0 0 1
8316 400 6 1 1 0 0 1
8382 400 7 1 1 0 0 1
8448 400 0 1 1 0 0 1
8514 400 1 1 1 0 0 1
8580 400 2 1 1 0 0 1
8646 400 3 1 1 0 0 1
8712 400 4 1 1 0 0 1
8778 400 5 1 1 0 0 1
8844 400 6 1 1 0 0 1
8910 400 7 1 1 0 0 1
8976 400 0 1 1 0 0 1
9042 400 1 1 1 0 0 1
9108 400 2 1 1 0 0 1
9174 400 3 1 1 0 0 1
9240 400 4 1 1 0 0 1
9306 400 5 1 1 0 0 1
9372 400 6 1 1 0 0 1
9438 400 7 1 1 0 0 1
9504 400 0 1 1 0 0 1
9570 400 1 1 1 0 0 1
9636 400 2 1 1 0 0 1
9702 400 3 1 1 0 0 1
9768 400 4 1 1 0 0 1
9834 400 5 1 1 0 0 1
9900 400 6 1 1 0 0 1
9966 400 7 1 1 0 0 1
10032 400 0 1 1 0 0 1
10098 400 1 1 1 0 0 1
10164 400 2 1 1 0 0 1
10230 400 3 1 1 0 0 1
10296 400 4 1 1 0 0 1
10362 400 5 1 1 0 0 1
10428 400 6 1 1 0 0 1
10494 400 7 1 1 0 0 1
10560 400 0 1 1 0 0 1
10626 400 1 1 1 0 0 1
10692 400 2 1 1 0 0 1
10758 400 3 1 1 0 0 1
10824 400 4 1 1 0 0 1
10890 400 5 1 1 0 0 1
10956 400 6 1 1 0 0 1
11022 400 7 1 1 0 0 1
11088 400 0 1 1 0 0 1
11154 400 1 1 1 0 0 1
11220 400 2 1 1 0 0 1
11286 400 3 1 1 0 0 1
11352 400 4 1 1 0 0 1
11418 400 5 1 1 0 0 1
11484 400 6 1 1 0 0 1
11550 400 7 1 1 0 0 1
11616 400 0 1 1 0 0 1
11682 400 1 1 1 0 0 1
11748 400 2 1 1 0 0 1
11814 400 3 1 1 0 0 1
11880 400 4 1 1 0 0 1
11946 400 5 1 1 0 0 1
12012 400 6 1 1 0 0 1
12078 400 7 1 1 0 0 1
12144 400 0 1 1 0 0 1
12210 400 1 1 1 0 0 1
12276 400 2 1 1 0 0 1
12342 400 3 1 1 0 0 1
12408 400 4 1 1 0 0 1
12474 400 5 1 1 0 0 1
12540 400 6 1 1 0 0 1
12606 400 7 1 1 0 0 1
12672 400 0 1 1 0 0 1
12738 400 1 1 1 0 0 1
12804 400 2 1 1 0 0 1
12870 400 3 1 1 0 0 1
12936 400 4 1 1 0 0 1
13002 400 5 1 1 0 0 1
13068 400 6 1 1 0 0 1
13134 400 7 1 0 0 0 1
